0 0
9 9
0011111111
1001000101
1100010001
1001010101
1100010001
1101010101
1000100011
1101011011
1001011001
1100011100