0 0 
13 20
001111111111111111111
100000001101011111111
111010101100000110011
111000101101110111011
100011001101110111011
110100011101110000011
110101100001000101111
000000011011011101111
110101011010011001001
100101011010111011011
101001010000010011011
100011010101010111011
110100000100000000000
110101111111111111110