0 0
19 19
00111111111001010101
10010001011100000000
11000100011101111100
10010101011100111100
11000100011100110001
11010101000101110001
10001000110100110001
11010110110101010100
10010110010100110001
11000111000100111100
00111111011100111100
10010001011100110001
11000100011100111100
10010101000001010101
11000100011100011100
11010101000101000001
10001000110101011100
11010110110001010101
10010110011100001100
11000111001100010000
