0 0
49 49
00111111110011111111001111111100111111110011111111
10000101011000010101100001010110000101011000010101
11010101011101010101110101010111010101011101010101
10010101011001010101100101010110010101011001010101
10010101011001010101100101010110010101011001010101
11010101011101010101110101010111010101011101010101
10010101011001010101100101010110010101011001010101
11010101011101010101110101010111010101011101010101
10010000011001000001100100000110010000011001000001
11111111000011111100001111110000111111000011111100
00111111110011111111001111111100111111110011111111
10000101011000010101100001010110000101011000010101
11010101011101010101110101010111010101011101010101
10010101011001010101100101010110010101011001010101
10010101011001010101100101010110010101011001010101
11010101011101010101110101010111010101011101010101
10010101011001010101100101010110010101011001010101
11010101011101010101110101010111010101011101010101
10010000011001000001100100000110010000011001000001
11111111000011111100001111110000111111000011111100
00111111110011111111001111111100111111110011111111
10000101011000010101100001010110000101011000010101
11010101011101010101110101010111010101011101010101
10010101011001010101100101010110010101011001010101
10010101011001010101100101010110010101011001010101
11010101011101010101110101010111010101011101010101
10010101011001010101100101010110010101011001010101
11010101011101010101110101010111010101011101010101
10010000011001000001100100000110010000011001000001
11111111000011111100001111110000111111000011111100
00111111110011111111001111111100111111110011111111
10000101011000010101100001010110000101011000010101
11010101011101010101110101010111010101011101010101
10010101011001010101100101010110010101011001010101
10010101011001010101100101010110010101011001010101
11010101011101010101110101010111010101011101010101
10010101011001010101100101010110010101011001010101
11010101011101010101110101010111010101011101010101
10010000011001000001100100000110010000011001000001
11111111000011111100001111110000111111000011111100
00111111110011111111001111111100111111110011111111
10000101011000010101100001010110000101011000010101
11010101011101010101110101010111010101011101010101
10010101011001010101100101010110010101011001010101
10010101011001010101100101010110010101011001010101
11010101011101010101110101010111010101011101010101
10010101011001010101100101010110010101011001010101
11010101011101010101110101010111010101011101010101
10010000011001000001100100000110010000011001000001
11111111000011111100001111110000111111000011111100