0 0
99 99
0011111111001111111100111111110011111111001111111100111111110011111111001111111100111111110011111111
1000010101100001010110000101011000010101100001010110000101011000010101100001010110000101011000010101
1101010101110101010111010101011101010101110101010111010101011101010101110101010111010101011101010101
1001010101100101010110010101011001010101100101010110010101011001010101100101010110010101011001010101
1001010101100101010110010101011001010101100101010110010101011001010101100101010110010101011001010101
1101010101110101010111010101011101010101110101010111010101011101010101110101010111010101011101010101
1001010101100101010110010101011001010101100101010110010101011001010101100101010110010101011001010101
1101010101110101010111010101011101010101110101010111010101011101010101110101010111010101011101010101
1001000001100100000110010000011001000001100100000110010000011001000001100100000110010000011001000001
1111111100001111110000111111000011111100001111110011111111000011111100001111110000111111000011111100
0011111111001111111100111111110011111111001111111100111111110011111111001111111100111111110011111111
1000010101100001010110000101011000010101100001010110000101011000010101100001010110000101011000010101
1101010101110101010111010101011101010101110101010111010101011101010101110101010111010101011101010101
1001010101100101010110010101011001010101100101010110010101011001010101100101010110010101011001010101
1001010101100101010110010101011001010101100101010110010101011001010101100101010110010101011001010101
1101010101110101010111010101011101010101110101010111010101011101010101110101010111010101011101010101
1001010101100101010110010101011001010101100101010110010101011001010101100101010110010101011001010101
1101010101110101010111010101011101010101110101010111010101011101010101110101010111010101011101010101
1001000001100100000110010000011001000001100100000110010000011001000001100100000110010000011001000001
1111111100001111110000111111000011111100001111110011111111000011111100001111110000111111000011111100
0011111111001111111100111111110011111111001111111100111111110011111111001111111100111111110011111111
1000010101100001010110000101011000010101100001010110000101011000010101100001010110000101011000010101
1101010101110101010111010101011101010101110101010111010101011101010101110101010111010101011101010101
1001010101100101010110010101011001010101100101010110010101011001010101100101010110010101011001010101
1001010101100101010110010101011001010101100101010110010101011001010101100101010110010101011001010101
1101010101110101010111010101011101010101110101010111010101011101010101110101010111010101011101010101
1001010101100101010110010101011001010101100101010110010101011001010101100101010110010101011001010101
1101010101110101010111010101011101010101110101010111010101011101010101110101010111010101011101010101
1001000001100100000110010000011001000001100100000110010000011001000001100100000110010000011001000001
1111111100001111110000111111000011111100001111110011111111000011111100001111110000111111000011111100
0011111111001111111100111111110011111111001111111100111111110011111111001111111100111111110011111111
1000010101100001010110000101011000010101100001010110000101011000010101100001010110000101011000010101
1101010101110101010111010101011101010101110101010111010101011101010101110101010111010101011101010101
1001010101100101010110010101011001010101100101010110010101011001010101100101010110010101011001010101
1001010101100101010110010101011001010101100101010110010101011001010101100101010110010101011001010101
1101010101110101010111010101011101010101110101010111010101011101010101110101010111010101011101010101
1001010101100101010110010101011001010101100101010110010101011001010101100101010110010101011001010101
1101010101110101010111010101011101010101110101010111010101011101010101110101010111010101011101010101
1001000001100100000110010000011001000001100100000110010000011001000001100100000110010000011001000001
1111111100001111110000111111000011111100001111110011111111000011111100001111110000111111000011111100
0011111111001111111100111111110011111111001111111100111111110011111111001111111100111111110011111111
1000010101100001010110000101011000010101100001010110000101011000010101100001010110000101011000010101
1101010101110101010111010101011101010101110101010111010101011101010101110101010111010101011101010101
1001010101100101010110010101011001010101100101010110010101011001010101100101010110010101011001010101
1001010101100101010110010101011001010101100101010110010101011001010101100101010110010101011001010101
1101010101110101010111010101011101010101110101010111010101011101010101110101010111010101011101010101
1001010101100101010110010101011001010101100101010110010101011001010101100101010110010101011001010101
1101010101110101010111010101011101010101110101010111010101011101010101110101010111010101011101010101
1001000001100100000110010000011001000001100100000110010000011001000001100100000110010000011001000001
1111111100001111110000111111000011111100001111110001111111000011111100001111110000111111000011111100
0011111111001111111100111111110011111111001111111100111111110011111111001111111100111111110011111111
1000010101100001010110000101011000010101100001010110000101011000010101100001010110000101011000010101
1101010101110101010111010101011101010101110101010111010101011101010101110101010111010101011101010101
1001010101100101010110010101011001010101100101010110010101011001010101100101010110010101011001010101
1001010101100101010110010101011001010101100101010110010101011001010101100101010110010101011001010101
1101010101110101010111010101011101010101110101010111010101011101010101110101010111010101011101010101
1001010101100101010110010101011001010101100101010110010101011001010101100101010110010101011001010101
1101010101110101010111010101011101010101110101010111010101011101010101110101010111010101011101010101
1001000001100100000110010000011001000001100100000110010000011001000001100100000110010000011001000001
1111111100001111110000111111000011111100001111110011111111000011111100001111110000111111000011111100
0011111111001111111100111111110011111111001111111100111111110011111111001111111100111111110011111111
1000010101100001010110000101011000010101100001010110000101011000010101100001010110000101011000010101
1101010101110101010111010101011101010101110101010111010101011101010101110101010111010101011101010101
1001010101100101010110010101011001010101100101010110010101011001010101100101010110010101011001010101
1001010101100101010110010101011001010101100101010110010101011001010101100101010110010101011001010101
1101010101110101010111010101011101010101110101010111010101011101010101110101010111010101011101010101
1001010101100101010110010101011001010101100101010110010101011001010101100101010110010101011001010101
1101010101110101010111010101011101010101110101010111010101011101010101110101010111010101011101010101
1001000001100100000110010000011001000001100100000110010000011001000001100100000110010000011001000001
1111111100001111110000000011000011111100001111110001111111000011101100001111110000111111000011111100
0011111111001111111100111111110011111111001111111100111111110011101111001111111100111111110011111111
1000010101100001010110000101011000010101100001010110000101011000000101100001010110000101011000010101
1101010101110101010111010101011101010101110101010111010101011101010101110101010111010101011101010101
1001010101100101010110010101011001010101100101010110010101011001010101100101010110010101011001010101
1001010101100101010110010101011001010101100101010110010101011001010101100101010110010101011001010101
1101010101110101010111010101011101010101110101010111010101011101010101110101010111010101011101010101
1001010101100101010110010101011001010101100101010110010101011001010101100101010110010101011001010101
1101010101110101010111010101011101010101110101010111010101011101010101110101010111010101011101010101
1001000001100100000110010000011001000001100100000110010000011001000001100100000110010000011001000001
1111111100001111110000111111000011111100001111110011111111000011111100001111110000111111000011111100
0011111111001111111100111111110011111111001111111100111111110011111111001111111100111111110011111111
1000010101100001010110000101011000010101100001010110000101011000010101100001010110000101011000010101
1101010101110101010111010101011101010101110101010111010101011101010101110101010111010101011101010101
1001010101100101010110010101011001010101100101010110010101011001010101100101010110010101011001010101
1001010101100101010110010101011001010101100101010110010101011001010101100101010110010101011001010101
1101010101110101010111010101011101010101110101010111010101011101010101110101010111010101011101010101
1001010101100101010110010101011001010101100101010110010101011001010101100101010110010101011001010101
1101010101110101010111010101011101010101110101010111010101011101010101110101010111010101011101010101
1001000001100100000110010000011001000001100100000110010000011001000001100100000110010000011001000001
1111111100001111110000111111000011111100001111110011111111000011111100001111110000111111000011111100
0011111111001111111100111111110011111111001111111100111111110011111111001111111100111111110011111111
1000010101100001010110000101011000010101100001010110000101011000010101100001010110000101011000010101
1101010101110101010111010101011101010101110101010111010101011101010101110101010111010101011101010101
1001010101100101010110010101011001010101100101010110010101011001010101100101010110010101011001010101
1001010101100101010110010101011001010101100101010110010101011001010101100101010110010101011001010101
1101010101110101010111010101011101010101110101010111010101011101010101110101010111010101011101010101
1001010101100101010110010101011001010101100101010110010101011001010101100101010110010101011001010101
1101010101110101010111010101011101010101110101010111010101011101010101110101010111010101011101010101
1001000001100100000110010000011001000001100100000110010000011001000001100100000110010000011001000001
1111111100001111110000111111000011111100001111110011111111000011111100001111110000111111000011111100