0 0
49 49
01001000011000010000010010000100000100010000110010
00000001010001100101000000100000010100000110001000
00000001100010000010110010100100100000001000000001
00000001000000000010000000000010001001010100000000
00100100001000000000001000100000000011000000000000
00001010010100010001000000010000000001000001001100
00000000000000000001000001010001000100001000000001
00100001001001101000010011000100011000000000001000
01110000001011100001010100100001000001000000001010
00000000010011010000000000010010000001000000000000
01001010001001001100000010011000000000100000000100
01000100000000000000100001000000000010001010000010
00101100000100000000000000001010001000010001100000
01100000000100000100100000000000000101001010000000
00100001000001100101000001010101000001000100001000
10100000000100010101010000000000000000000000000001
00001000011000010000110000010000001000000000011011
01010010000100010100000101000000010000000000000110
00010011000000000001000100101000000000000001000000
01000000000100000000000001000001000100000010000100
00011000001110000001000100100101010001001010000001
01100000000000001010001000101001110000000000000001
01000011000000011101001000100001000001010000010000
01000000000011001000000100001000000000000000000000
00000000001100001100000000001000001000000010000101
00000010000000010000000000000010000101000001000001
00000001000000000100000010100000001011000100000010
00000100000100000110001001110100000000000001000000
00010110000000010010000001000000000000000001000011
00000010000000000110000001000000110110100000000010
00000000110000000000011000100000010001010011000010
00000010101000100110000000000100000101000000100010
00000000010000100010010000000000001010001101100001
00101010100000000000000000000000000000000000000001
00001010110000000010100000000100011000010010000010
00000000011000000000000000001000100010000100100000
10010000010110001100100100000000001011001100000100
00001000000010000000100011010000000010001010000001
00000000000000000000000011000000100001010000000000
01110100000010000000010101000100010010011000000000
01010000000001010101000100000000000001000100010100
00000101000001110000010110100010101100011110010000
10000000010000110000000000001000100000000000000000
00001000000010000000000010010010000000111000101000
00001000000001000000100010000000100000010010000000
11000000000000100001000000000001010000000000000000
00001010100010000001001100000000001001011111000111
00111000000100000000000100000000000000001110000110
01000100001000000000000000110000000000010000010000
00000010001100001000010111110000000110100100000010